#########
#       #
# # # # #
#       #
#########